    
 NO      /home/zephyr/school21/06_cub3d/pics/blue_brick.xpm 
R 800  600

 F 47, 173,  79   
    C 33, 205, 200 

    S /home/zephyr/school21/06_cub3d/pics/barrel.xpm
 WE   /home/zephyr/school21/06_cub3d/pics/LAND2.xpm
 SO /home/zephyr/school21/06_cub3d/pics/redbrick.xpm
 EA   /home/zephyr/school21/06_cub3d/pics/wood.xpm


111 1 1
   10101
111 111  1
11111011101
11100000011111111
11011101101         1
10100000001 
111111110001   111111111111111        1
1      11001
 111 1  1001                 11111111111111111111
        10011111111111111111100000000000000000001
        10000000001100000200010101010000000011111
        1011000001110002000000000100110010000011
        10000000000000000001112001010011111111
11111111101100000111000200000000000000000001
1000000000110000011101011E11111111111111111
11110111111111011100000010001
11110111111111011101010010001
11000000110101011100000010001
1000000000000000000000010001
10000000000000001101010010001
1100000111010101111101111000111
11110111 1110101 101111010001
11111111 1111111 111111111111