 R           1024 768 F 111, 1,  44  C 2, 3, 4 
  
    S qq.s
 WE west.bmp
 SO south.bmp
 EA east.bmp
 NO   /home/zephyr/school21/06_cub3d/pics/eagle.xpm


   111
   101
   1S01
   11111